	 NO tex/hell.png
EA tex/hell.png
 SO		 tex/hell.png
WE   			tex/hell.png

C 	20, 20,	 20
F 30, 30,	 30

111111111111111111111111111111111111111111111111111111111111111111111111111111
11111111111111111111111000000111111111111111111111100000011111111111111111111111
11000000000000000000001000000100000000000000000000100000010000000000000000000011
11000000000000000000001000000100000000000000000000100000010000000000000000000011
11000000000000000000001000000100000000000000000000100000010000000000000000000011
11000000000000000000001000000100000000000000000000100000010000000000000000000011
11000000000000000000000000000000000000000000000000000000000000000000000000000011
11000000000000000000001000000100000000000000000000100000010000000000000000000011
11000000000000000000001000000100000000000000000000100000010000000000000000000011
11000000000000000000001000000100000000000000000000100000010000000000000000000011
11000000000000000000001000000100000000000000000000100000010000000000000000000011
11111111111001111111111000000111111111100111111111100000011111111110011111111111
10000000000000000000000000000000000000000000000000000000000000000000000000000001
10000000000000000000000000110000000000000000000000000011000000000000000000000001
10000000000000000000000000110000000000000000000000000011000000000000000000000001
10000000000000000000000000000000000000000000000000000000000000000000000000000001
111111111110011111111110000000000000000S0000000000000000011111111110011111111111
11000000000000000000001000000000000000000000000000000000010000000000000000000011
1100000000000000000000100000000000000000000000000000000010000000000000000000011
1100000000000000000000100000000000000000000000000000000010000000000000000000011
11000000000000000000001000000000000000010000000000000000010000000000000000000011
11000000000000000000000000000000000000111000000000000000000000000000000000000011
1100000000000000000000100000000000000001000000000000000001000000000000000000001
11000000000000000000001000000000000000000000000000000000010000000000000000000011
11000000000000000000001000000000000000000000000000000000010000000000000000000011
11000000000000000000001000000000000000000000000000000000010000000000000000000011
11111111111001111111111000000000000000000000000000000000011111111110011111111111
10000000000000000000000000000000000000000000000000000000000000000000000000000001
10000000000000000000000000110000000000000000000000000011000000000000000000000001
10000000000000000000000000110000000000000000000000000011000000000000000000000001
10000000000000000000000000000000000000000000000000000000000000000000000000000001
11111111111001111111111000000111111111100111111111100000011111111110011111111111
11000000000000000000001000000100000000000000000000100000010000000000000000000011
11000000000000000000001000000100000000000000000000100000010000000000000000000011
11000000000000000000001000000100000000000000000000100000010000000000000000000011
11000000000000000000001000000100000000000000000000100000010000000000000000000011
11000000000000000000000000000000000000000000000000000000000000000000000000000011
11000000000000000000001000000100000000000000000000100000010000000000000000000011
11000000000000000000001000000100000000000000000000100000010000000000000000000011
11000000000000000000001000000100000000000000000000100000010000000000000000000011
11000000000000000000001000000100000000000000000000100000010000000000000000000011
11111111111111111111111000000111111111111111111111100000011111111111111111111111
111111111111111111111111111111111111	111111111111111111111111111111111111111111
