NO tex/hospital/wall/north.png
EA tex/hospital/wall/east.png
SO tex/hospital/wall/south.png
WE tex/hospital/wall/west.png

C tex/hospital/ceiling/ceiling.png
F tex/hospital/floor/floor.png

11111111111111111111111111
1LLL11111LLL01L00000111001
10X000X01000000000001111X1
10010000D0X0000W1110000101
10X00000100010100011110001
1LL1111LLL1111L10001110111
11111111111111111111111111
