	 NO tex/matrix/wall/wall.png
EA tex/matrix/wall/wall.png
 SO		 tex/matrix/wall/wall.png
WE   			tex/matrix/wall/wall.png

C tex/matrix/ceiling/ceiling.png
F tex/matrix/floor/floor.png

11111   111111111111111111
1L00111110Z001L000001 1001
1L000010010L0100001D111101111
101000L00D00000W1110000101
10000000110Y10101011110001
100111100L1111010001 10111
1111  11111  11111111111
