	 NO tex/matrix.png
EA tex/matrix.png
 SO		 tex/matrix.png
WE   			tex/matrix.png

D tex/matrix.png

C tex/matrix.png
F tex/matrix.png

11111   111111111111111111
1L00111110Z001L000001 1001
1L0000100100010000101111D1111
101000000000000W11100D0101
10000000100Y10101011110001
100111100L1111010001 10111
1111  11111  11111111111
