NO tex/space/wall/wall.png
EA tex/space/wall/wall.png
SO tex/space/wall/wall.png
WE tex/space/wall/wall.png

C tex/space/ceiling/ceiling.png
F tex/space/floor/floor.png

1111111111111111111111111
1000000000000000000000001
100000000000Z000000000001
10X0000000000000000000001
10N000000000Y000000000001
1000000000000000000000001
1111111111111111111111111
