	 NO tex/wall1.png
EA tex/wall1.png
SO		 tex/wall1.png
WE tex/wall1.png

D tex/wall1.png

F 135,109,	 70
C 181,171,107

11111   111111111111111111
10001111100Z01000001 10D01
100000100100Z10000111101D1
10X0000N00000D01010D0D0101
100000000010Y1010101110101
10011110001111010001 10111
1111  11111  11111111111
