	 NO tex/wall1.png
EA tex/wall1.png
SO		 tex/wall1.png
WE tex/wall1.png

F 135,109,	 70
C 181,171,107

	1111111111111111
1000000000000101
10X0000N00000D01
100000000000X101
1001111000111101
1111	 11111 1111111
