NO tex/test/north.png
EA tex/test/east.png
WE tex/test/west.png
SO tex/test/south.png

C 50, 50, 50
F 50, 50, 50

1111111111111111111111111
1000000000000000000000001
1000000000000000000000001
1000000000000000000000001
10N0000000000000000000001
1000000000000000000000001
1111111111111111111111111
