	 NO tex/wall1.png
EA tex/wall1.png
SO		 tex/wall1.png
WE tex/wall1.png

D tex/wall1.png

F 135,109,	 70
C 181,171,107

		11111111111111111101
10000000000Z01000101
10X0010N00000D010101
100000000010Y1010101
10011110001111010101
1111	 11111 1111111111
